ramdin verma	indian
sharat chandran	indian
birender mandal	indian
amit	indian
kushal	indian
kasid	indian
shiv prakash	indian
vikram singh	indian
sanjay	indian
abhi	indian
ram dutt gupta	indian
khadak singh	indian
gurmit singh	indian
chanderpal	indian
aman	indian
khursid	indian
rajeev	indian
durgesh	indian
marched	VBN
through	IN
London	NNP